# Types

MenuShow	KEYWORD1
MenuAction	KEYWORD1
MenuNav	KEYWORD1
MenuItemFunc_t	KEYWORD1
MenuNavFunc_t	KEYWORD1
MenuItem	KEYWORD1
Menu	KEYWORD1
MenuState	KEYWORD1


# Functions

menu_EnterMenu	KEYWORD2
menu_LeaveMenu	KEYWORD2
menu_Init	KEYWORD2
menu_Process	KEYWORD2
menu_ShowCB	KEYWORD2


# Global variables

menu_gCurMenu	KEYWORD3
menu_gCurItem	KEYWORD3
menu_gStack	KEYWORD3
menu_gpCurState	KEYWORD3


# Literal values

MENU_STACKDEPTH	LITERAL1

MENUSHOW_MENU	LITERAL1
MENUSHOW_ITEM	LITERAL1

MENUACTION_NONE	LITERAL1
MENUACTION_PREV	LITERAL1
MENUACTION_NEXT	LITERAL1
MENUACTION_SELECT	LITERAL1

MENUNAV_MENU	LITERAL1
MENUNAV_CHANGE	LITERAL1
MENUNAV_SELECT	LITERAL1

MENUITEMFUNC_PROTO	LITERAL1
MENUNAVFUNC_PROTO	LITERAL1

MENUITEMLIST	LITERAL1
MENUITEMLISTEND	LITERAL1
MENUITEM	LITERAL1
